UltrasonicSensor	KEYWORD1
StoppingDistance KEYWORD3
Get	KEYWORD2
Blocked	KEYWORD2
Leg	KEYWORD1
UpEngine	KEYWORD3
DownEngine	KEYWORD3
Promote	KEYWORD2
DisPromote	KEYWORD2
SwimAhed	KEYWORD2
SwimBack	KEYWORD2
Align	KEYWORD2
Set	KEYWORD2
Hello	KEYWORD2
SetSpeed	KEYWORD2
SEngine KEYWORD1
Goto	KEYWORD2
Move	KEYWORD2
GetDegrees	KEYWORD2
Reverse	KEYWORD2
SetPin	KEYWORD2
Spider KEYWORD1
DefaultVerticalAngles	KEYWORD3
DefaulthorizontalAngles	KEYWORD3
Step	KEYWORD2
AttracAttention	KEYWORD2
Hello	KEYWORD2
MakeNois	KEYWORD2
Sleep	KEYWORD2
WakeUp	KEYWORD2
Climb	KEYWORD2
Print	KEYWORD2
Speak	KEYWORD2
AlignAllLegs	KEYWORD2
Straight	KEYWORD2
TopDistance	KEYWORD2
BottomDistance	KEYWORD2
GetDistance	KEYWORD2